CT
A: B w w U
B: C w A V
C: D w B W
D: E w C X
E: F w D Y
F: G w E Z
G: H w F AA
H: I w G AB
I: w w H AC
J: K w w AD
K: L w J AE
L: M w K AF
M: N w L AG
N: O w M AH
O: P w N AI
P: Q w O AJ
Q: R w P AK
R: S w Q AL
S: T w R AM
T: w w S AN
U: V A w AO
V: W B U AP
W: X C V AQ
X: Y D W AR
Y: Z E X AS
Z: AA F Y AT
AA: AB G Z AU
AB: AC H AA AV
AC: w I AB AW
AD: AE J w AX
AE: AF K AD AY
AF: AG L AE AZ
AG: AH M AF BA
AH: AI N AG BB
AI: AJ O AH BC
AJ: AK P AI BD
AK: AL Q AJ BE
AL: AM R AK BF
AM: AN S AL BG
AN: w T AM BH
AO: AP U w BI
AP: AQ V AO BJ
AQ: AR W AP BK
AR: AS X AQ BL
AS: AT Y AR BM
AT: AU Z AS BN
AU: AV AA AT BO
AV: AW AB AU BP
AW: w AC AV BQ
AX: AY AD w BR
AY: AZ AE AX BS
AZ: BA AF AY BT
BA: BB AG AZ BU
BB: BC AH BA BV
BC: BD AI BB BW
BD: BE AJ BC BX
BE: BF AK BD BY
BF: BG AL BE BZ
BG: BH AM BF CA
BH: w AN BG CB
BI: BJ AO w CC
BJ: BK AP BI CD
BK: BL AQ BJ CE
BL: BM AR BK CF
BM: BN AS BL CG
BN: BO AT BM CH
BO: BP AU BN CI
BP: BQ AV BO CJ
BQ: w AW BP CK
BR: BS AX w CL
BS: BT AY BR CM
BT: BU AZ BS CN
BU: BV BA BT w
BV: BW BB BU w
BW: BX BC BV w
BX: BY BD BW w
BY: BZ BE BX w
BZ: CA BF BY w
CA: CB BG BZ CU
CB: w BH CA CV
CC: CD BI w CW
CD: CE BJ CC CX
CE: CF BK CD CY
CF: CG BL CE CZ
CG: CH BM CF DA
CH: CI BN CG DB
CI: CJ BO CH DC
CJ: CK BP CI DD
CK: w BQ CJ DE
CL: CM BR w DF
CM: CN BS CL DG
CN: CO BT CM DH
CO: CP w CN w
CP: CQ w CO w
CQ: CR w CP w
CR: CS w CQ w
CS: CT w CR w
CT: w w CS w
CU: CV CA w DO
CV: w CB CU DP
CW: CX CC w DQ
CX: CY CD CW DR
CY: CZ CE CX DS
CZ: DA CF CY DT
DA: DB CG CZ DU
DB: DC CH DA DV
DC: DD CI DB DW
DD: DE CJ DC DX
DE: w CK DD DY
DF: DG CL w DZ
DG: DH CM DF EA
DH: DI CN DG EB
DI: DJ w DH EC
DJ: w w DI ED
DK: DL w w EE
DL: DM w DK EF
DM: DN w DL EG
DN: DO w DM EH
DO: DP CU DN EI
DP: w CV DO EJ
DQ: DR CW w EK
DR: DS CX DQ EL
DS: DT CY DR w
DT: DU CZ DS w
DU: DV DA DT w
DV: DW DB DU w
DW: DX DC DV w
DX: DY DD DW w
DY: w DE DX w
DZ: EA DF w w
EA: EB DG DZ EU
EB: EC DH EA EV
EC: ED DI EB EW
ED: w DJ EC EX
EE: EF DK w EY
EF: EG DL EE EZ
EG: EH DM EF FA
EH: EI DN EG FB
EI: EJ DO EH FC
EJ: w DP EI FD
EK: EL DQ w FE
EL: EM DR EK FF
EM: EN w EL FG
EN: EO w EM FH
EO: EP w EN FI
EP: EQ w EO FJ
EQ: ER w EP FK
ER: ES w EQ FL
ES: w w ER FM
ET: EU w w FN
EU: EV EA ET FO
EV: EW EB EU FP
EW: EX EC EV FQ
EX: w ED EW FR
EY: EZ EE w FS
EZ: FA EF EY FT
FA: FB EG EZ w
FB: FC EH FA w
FC: FD EI FB w
FD: w EJ FC w
FE: FF EK w FY
FF: FG EL FE FZ
FG: FH EM FF GA
FH: FI EN FG GB
FI: FJ EO FH GC
FJ: FK EP FI GD
FK: FL EQ FJ GE
FL: FM ER FK GF
FM: w ES FL GG
FN: FO ET w GH
FO: FP EU FN GI
FP: FQ EV FO GJ
FQ: FR EW FP GK
FR: w EX FQ GL
FS: FT EY w GM
FT: w EZ FS GN
FY: FZ FE w GS
FZ: GA FF FY GT
GA: GB FG FZ GU
GB: GC FH GA GV
GC: GD FI GB GW
GD: GE FJ GC GX
GE: GF FK GD GY
GF: GG FL GE GZ
GG: w FM GF HA
GH: GI FN w HB
GI: GJ FO GH HC
GJ: GK FP GI HD
GK: GL FQ GJ HE
GL: w FR GK HF
GM: GN FS w HG
GN: w FT GM HH
GS: GT FY w HM
GT: GU FZ GS HN
GU: GV GA GT HO
GV: GW GB GU HP
GW: GX GC GV HQ
GX: w GD GW HR
GY: GZ GE w HS
GZ: HA GF GY HT
HA: w GG GZ HU
HB: HC GH w HV
HC: HD GI HB HW
HD: HE GJ HC HX
HE: HF GK HD HY
HF: w GL HE HZ
HG: HH GM w w
HH: w GN HG w
HM: HN GS w IG
HN: HO GT HM IH
HO: HP GU HN II
HP: HQ GV HO IJ
HQ: HR GW HP IK
HR: w GX HQ IL
HS: HT GY w IM
HT: HU GZ HS IN
HU: w HA HT IO
HV: HW HB w IP
HW: HX HC HV IQ
HX: HY HD HW IR
HY: HZ HE HX IS
HZ: w HF HY IT
IA: IB w w IU
IB: w w IA IV
IG: IH HM w JA
IH: II HN IG JB
II: IJ HO IH JC
IJ: IK HP II JD
IK: IL HQ IJ JE
IL: w HR IK JF
IM: IN HS w JG
IN: IO HT IM JH
IO: w HU IN JI
IP: IQ HV w JJ
IQ: IR HW IP JK
IR: IS HX IQ JL
IS: IT HY IR JM
IT: w HZ IS JN
IU: IV IA w JO
IV: w IB IU JP
JA: JB IG w JU
JB: JC IH JA JV
JC: JD II JB JW
JD: JE IJ JC JX
JE: JF IK JD JY
JF: w IL JE JZ
JG: JH IM w KA
JH: JI IN JG KB
JI: w IO JH KC
JJ: JK IP w KD
JK: JL IQ JJ KE
JL: JM IR JK KF
JM: JN IS JL KG
JN: w IT JM KH
JO: JP IU w KI
JP: JQ IV JO KJ
JQ: JR w JP KK
JR: w w JQ KL
JS: JT w w KM
JT: sa√≠da w JS KN
JU: JV JA w KO
JV: JW JB JU KP
JW: JX JC JV KQ
JX: JY JD JW KR
JY: JZ JE JX KS
JZ: w JF JY KT
KA: KB JG w KU
KB: KC JH KA KV
KC: KD JI KB KW
KD: KE JJ KC KX
KE: KF JK KD KY
KF: KG JL KE KZ
KG: KH JM KF LA
KH: w JN KG LB
KI: w JO w LC
KJ: KK JP w LD
KK: KL JQ KJ LE
KL: w JR KK LF
KM: KN JS w LG
KN: w JT KM LH
KO: KP JU w LI
KP: KQ JV KO LJ
KQ: KR JW KP LK
KR: KS JX KQ LL
KS: KT JY KR LM
KT: w JZ KS LN
KU: KV KA w w
KV: KW KB KU w
KW: KX KC KV w
KX: KY KD KW w
KY: KZ KE KX w
KZ: LA KF KY w
LA: LB KG KZ w
LB: w KH LA w
LC: w KI w LW
LD: LE KJ w LX
LE: LF KK LD LY
LF: w KL LE LZ
LG: LH KM w MA
LH: w KN LG MB
LI: LJ KO w MC
LJ: LK KP LI MD
LK: LL KQ LJ ME
LL: LM KR LK MF
LM: LN KS LL MG
LN: LO KT LM MH
LO: LP w LN MI
LP: LQ w LO MJ
LQ: LR w LP MK
LR: LS w LQ ML
LS: LT w LR MM
LT: LU w LS MN
LU: LV w LT MO
LV: LW w LU MP
LW: w LC LV MQ
LX: LY LD w MR
LY: LZ LE LX MS
LZ: w LF LY MT
MA: MB LG w MU
MB: w LH MA MV
MC: MD LI w MW
MD: ME LJ MC MX
ME: MF LK MD MY
MF: MG LL ME MZ
MG: MH LM MF NA
MH: MI LN MG NB
MI: MJ LO MH NC
MJ: MK LP MI ND
MK: ML LQ MJ NE
ML: MM LR MK NF
MM: MN LS ML NG
MN: MO LT MM NH
MO: MP LU MN NI
MP: MQ LV MO NJ
MQ: w LW MP NK
MR: MS LX w NL
MS: MT LY MR NM
MT: w LZ MS NN
MU: MV MA w NO
MV: w MB MU NP
MW: MX MC w NQ
MX: MY MD MW NR
MY: MZ ME MX NS
MZ: NA MF MY NT
NA: NB MG MZ NU
NB: NC MH NA NV
NC: ND MI NB NW
ND: NE MJ NC NX
NE: NF MK ND NY
NF: NG ML NE NZ
NG: NH MM NF OA
NH: NI MN NG OB
NI: NJ MO NH OC
NJ: NK MP NI OD
NK: w MQ NJ OE
NL: NM MR w OF
NM: NN MS NL OG
NN: NO MT NM OH
NO: NP MU NN OI
NP: w MV NO OJ
NQ: NR MW w w
NR: NS MX NQ w
NS: NT MY NR w
NT: NU MZ NS w
NU: NV NA NT w
NV: NW NB NU w
NW: NX NC NV w
NX: NY ND NW w
NY: NZ NE NX w
NZ: OA NF NY w
OA: OB NG NZ w
OB: OC NH OA w
OC: OD NI OB w
OD: OE NJ OC w
OE: w NK OD w
OF: OG NL w w
OG: OH NM OF w
OH: OI NN OG w
OI: OJ NO OH w
OJ: w NP OI w
