BB
A: B w w K
B: C w A L
C: D w B M
D: E w C N
E: F w D O
F: G w E P
G: H w F Q
H: I w G R
I: J w H S
J: w w I T
K: L A w U
L: M B K V
M: N C L W
N: O D M X
O: P E N Y
P: Q F O Z
Q: R G P AA
R: S H Q AB
S: T I R AC
T: w J S AD
U: V K w AE
V: W L U AF
W: X M V AG
X: Y N W AH
Y: Z O X AI
Z: AA P Y AJ
AA: AB Q Z AK
AB: AC R AA AL
AC: AD S AB AM
AD: sa√≠da T AC AN
AE: AF U w AO
AF: AG V AE AP
AG: AH W AF AQ
AH: AI X AG AR
AI: AJ Y AH AS
AJ: AK Z AI AT
AK: AL AA AJ AU
AL: AM AB AK AV
AM: AN AC AL AW
AN: w AD AM AX
AO: AP AE w AY
AP: AQ AF AO AZ
AQ: AR AG AP BA
AR: AS AH AQ BB
AS: AT AI AR BC
AT: AU AJ AS BD
AU: AV AK AT BE
AV: AW AL AU BF
AW: AX AM AV BG
AX: w AN AW BH
AY: AZ AO w BI
AZ: BA AP AY BJ
BA: BB AQ AZ BK
BB: BC AR BA BL
BC: BD AS BB BM
BD: BE AT BC BN
BE: BF AU BD BO
BF: BG AV BE BP
BG: BH AW BF BQ
BH: w AX BG BR
BI: BJ AY w BS
BJ: BK AZ BI BT
BK: BL BA BJ BU
BL: BM BB BK BV
BM: BN BC BL BW
BN: BO BD BM BX
BO: BP BE BN BY
BP: BQ BF BO BZ
BQ: BR BG BP CA
BR: w BH BQ CB
BS: BT BI w CC
BT: BU BJ BS CD
BU: BV BK BT CE
BV: BW BL BU CF
BW: BX BM BV CG
BX: BY BN BW CH
BY: BZ BO BX CI
BZ: CA BP BY CJ
CA: CB BQ BZ CK
CB: w BR CA CL
CC: CD BS w CM
CD: CE BT CC CN
CE: CF BU CD CO
CF: CG BV CE CP
CG: CH BW CF CQ
CH: CI BX CG CR
CI: CJ BY CH CS
CJ: CK BZ CI CT
CK: CL CA CJ CU
CL: w CB CK CV
CM: CN CC w w
CN: CO CD CM w
CO: CP CE CN w
CP: CQ CF CO w
CQ: CR CG CP w
CR: CS CH CQ w
CS: CT CI CR w
CT: CU CJ CS w
CU: CV CK CT w
CV: w CL CU w
