D
A: B w w U
B: C w A V
C: D w B W
D: E w C X
E: F w D Y
F: G w E Z
G: H w F AA
H: I w G AB
I: J w H AC
J: K w I AD
K: L w J AE
L: M w K AF
M: N w L AG
N: O w M AH
O: P w N AI
P: Q w O AJ
Q: R w P AK
R: S w Q AL
S: T w R AM
T: w w S AN
U: V A w AO
V: W B U AP
W: X C V AQ
X: Y D W AR
Y: Z E X AS
Z: AA F Y AT
AA: AB G Z AU
AB: AC H AA AV
AC: AD I AB AW
AD: AE J AC AX
AE: AF K AD AY
AF: AG L AE AZ
AG: AH M AF BA
AH: AI N AG BB
AI: AJ O AH BC
AJ: AK P AI BD
AK: AL Q AJ BE
AL: AM R AK BF
AM: AN S AL BG
AN: w T AM BH
AO: AP U w BI
AP: AQ V AO BJ
AQ: AR W AP BK
AR: AS X AQ BL
AS: AT Y AR BM
AT: AU Z AS BN
AU: AV AA AT BO
AV: AW AB AU BP
AW: AX AC AV BQ
AX: AY AD AW BR
AY: AZ AE AX BS
AZ: BA AF AY BT
BA: BB AG AZ BU
BB: BC AH BA BV
BC: BD AI BB BW
BD: BE AJ BC BX
BE: BF AK BD BY
BF: BG AL BE BZ
BG: BH AM BF CA
BH: w AN BG CB
BI: BJ AO w CC
BJ: BK AP BI CD
BK: BL AQ BJ CE
BL: BM AR BK CF
BM: BN AS BL CG
BN: BO AT BM CH
BO: BP AU BN CI
BP: BQ AV BO CJ
BQ: BR AW BP CK
*BR: BS AX BQ CL
BS: BT AY BR CM
BT: BU AZ BS CN
BU: BV BA BT CO
BV: BW BB BU CP
BW: BX BC BV CQ
BX: BY BD BW CR
BY: BZ BE BX CS
BZ: CA BF BY CT
CA: CB BG BZ CU
CB: w BH CA CV
CC: CD BI w CW
CD: CE BJ CC CX
CE: CF BK CD CY
CF: CG BL CE CZ
CG: CH BM CF DA
CH: CI BN CG DB
CI: CJ BO CH DC
CJ: CK BP CI DD
CK: CL BQ CJ DE
CL: CM BR CK DF
CM: CN BS CL DG
CN: CO BT CM DH
CO: CP BU CN DI
CP: CQ BV CO DJ
CQ: CR BW CP DK
CR: CS BX CQ DL
CS: CT BY CR DM
CT: CU BZ CS DN
CU: CV CA CT DO
CV: w CB CU DP
CW: CX CC w DQ
CX: CY CD CW DR
CY: CZ CE CX DS
CZ: DA CF CY DT
DA: DB CG CZ DU
DB: DC CH DA DV
DC: DD CI DB DW
DD: DE CJ DC DX
DE: DF CK DD DY
DF: DG CL DE DZ
DG: DH CM DF EA
DH: DI CN DG EB
DI: DJ CO DH EC
DJ: DK CP DI ED
DK: DL CQ DJ EE
DL: DM CR DK EF
DM: DN CS DL EG
DN: DO CT DM EH
DO: DP CU DN EI
DP: w CV DO EJ
DQ: DR CW w EK
DR: DS CX DQ EL
DS: DT CY DR EM
DT: DU CZ DS EN
DU: DV DA DT EO
DV: DW DB DU EP
DW: DX DC DV EQ
DX: DY DD DW ER
DY: DZ DE DX ES
DZ: EA DF DY ET
EA: EB DG DZ EU
EB: EC DH EA EV
EC: ED DI EB EW
ED: EE DJ EC EX
EE: EF DK ED EY
EF: EG DL EE EZ
EG: EH DM EF FA
EH: EI DN EG FB
EI: EJ DO EH FC
EJ: w DP EI FD
EK: EL DQ w FE
EL: EM DR EK FF
*EM: EN DS EL FG
EN: EO DT EM FH
EO: EP DU EN FI
EP: EQ DV EO FJ
EQ: ER DW EP FK
ER: ES DX EQ FL
ES: ET DY ER FM
ET: EU DZ ES FN
EU: EV EA ET FO
EV: EW EB EU FP
EW: EX EC EV FQ
EX: EY ED EW FR
EY: EZ EE EX FS
EZ: FA EF EY FT
FA: FB EG EZ FU
FB: FC EH FA FV
FC: FD EI FB FW
FD: w EJ FC FX
FE: FF EK w FY
FF: FG EL FE FZ
FG: FH EM FF GA
FH: FI EN FG GB
FI: FJ EO FH GC
FJ: FK EP FI GD
FK: FL EQ FJ GE
FL: FM ER FK GF
FM: FN ES FL GG
FN: FO ET FM GH
FO: FP EU FN GI
FP: FQ EV FO GJ
FQ: FR EW FP GK
FR: FS EX FQ GL
FS: FT EY FR GM
FT: FU EZ FS GN
FU: FV FA FT GO
FV: FW FB FU GP
FW: FX FC FV GQ
FX: w FD FW GR
FY: FZ FE w GS
FZ: GA FF FY GT
GA: GB FG FZ GU
GB: GC FH GA GV
GC: GD FI GB GW
GD: GE FJ GC GX
GE: GF FK GD GY
GF: GG FL GE GZ
GG: GH FM GF HA
GH: GI FN GG HB
GI: GJ FO GH HC
GJ: GK FP GI HD
GK: GL FQ GJ HE
GL: GM FR GK HF
GM: GN FS GL HG
GN: GO FT GM HH
GO: GP FU GN HI
GP: GQ FV GO HJ
GQ: GR FW GP HK
GR: w FX GQ HL
GS: GT FY sa√≠da HM
GT: GU FZ GS HN
GU: GV GA GT HO
GV: GW GB GU HP
GW: GX GC GV HQ
GX: GY GD GW HR
GY: GZ GE GX HS
GZ: HA GF GY HT
HA: HB GG GZ HU
HB: HC GH HA HV
HC: HD GI HB HW
HD: HE GJ HC HX
HE: HF GK HD HY
HF: HG GL HE HZ
HG: HH GM HF IA
*HH: HI GN HG IB
HI: HJ GO HH IC
HJ: HK GP HI ID
HK: HL GQ HJ IE
HL: w GR HK IF
HM: HN GS w IG
HN: HO GT HM IH
HO: HP GU HN II
HP: HQ GV HO IJ
HQ: HR GW HP IK
HR: HS GX HQ IL
HS: HT GY HR IM
HT: HU GZ HS IN
HU: HV HA HT IO
HV: HW HB HU IP
HW: HX HC HV IQ
HX: HY HD HW IR
HY: HZ HE HX IS
HZ: IA HF HY IT
IA: IB HG HZ IU
IB: IC HH IA IV
IC: ID HI IB IW
ID: IE HJ IC IX
IE: IF HK ID IY
IF: w HL IE IZ
IG: IH HM w JA
IH: II HN IG JB
II: IJ HO IH JC
*IJ: IK HP II JD
IK: IL HQ IJ JE
IL: IM HR IK JF
IM: IN HS IL JG
IN: IO HT IM JH
IO: IP HU IN JI
IP: IQ HV IO JJ
IQ: IR HW IP JK
IR: IS HX IQ JL
IS: IT HY IR JM
IT: IU HZ IS JN
IU: IV IA IT JO
IV: IW IB IU JP
IW: IX IC IV JQ
IX: IY ID IW JR
IY: IZ IE IX JS
IZ: w IF IY JT
JA: JB IG w JU
JB: JC IH JA JV
JC: JD II JB JW
JD: JE IJ JC JX
JE: JF IK JD JY
JF: JG IL JE JZ
JG: JH IM JF KA
JH: JI IN JG KB
JI: JJ IO JH KC
JJ: JK IP JI KD
JK: JL IQ JJ KE
JL: JM IR JK KF
JM: JN IS JL KG
JN: JO IT JM KH
JO: JP IU JN KI
JP: JQ IV JO KJ
JQ: JR IW JP KK
JR: JS IX JQ KL
JS: JT IY JR KM
JT: w IZ JS KN
JU: JV JA w KO
JV: JW JB JU KP
JW: JX JC JV KQ
JX: JY JD JW KR
JY: JZ JE JX KS
JZ: KA JF JY KT
KA: KB JG JZ KU
KB: KC JH KA KV
KC: KD JI KB KW
KD: KE JJ KC KX
KE: KF JK KD KY
KF: KG JL KE KZ
KG: KH JM KF LA
KH: KI JN KG LB
KI: KJ JO KH LC
KJ: KK JP KI LD
KK: KL JQ KJ LE
KL: KM JR KK LF
KM: KN JS KL LG
KN: w JT KM LH
KO: KP JU w LI
KP: KQ JV KO LJ
KQ: KR JW KP LK
KR: KS JX KQ LL
KS: KT JY KR LM
KT: KU JZ KS LN
KU: KV KA KT LO
KV: KW KB KU LP
KW: KX KC KV LQ
KX: KY KD KW LR
KY: KZ KE KX LS
KZ: LA KF KY LT
LA: LB KG KZ LU
LB: LC KH LA LV
LC: LD KI LB LW
LD: LE KJ LC LX
LE: LF KK LD LY
LF: LG KL LE LZ
LG: LH KM LF MA
LH: w KN LG MB
LI: LJ KO w MC
LJ: LK KP LI MD
LK: LL KQ LJ ME
LL: LM KR LK MF
LM: LN KS LL MG
LN: LO KT LM MH
LO: LP KU LN MI
LP: LQ KV LO MJ
LQ: LR KW LP MK
LR: LS KX LQ ML
LS: LT KY LR MM
LT: LU KZ LS MN
LU: LV LA LT MO
LV: LW LB LU MP
LW: LX LC LV MQ
LX: LY LD LW MR
LY: LZ LE LX MS
LZ: MA LF LY MT
MA: MB LG LZ MU
MB: w LH MA MV
MC: MD LI w MW
MD: ME LJ MC MX
ME: MF LK MD MY
MF: MG LL ME MZ
MG: MH LM MF NA
MH: MI LN MG NB
MI: MJ LO MH NC
MJ: MK LP MI ND
MK: ML LQ MJ NE
ML: MM LR MK NF
MM: MN LS ML NG
MN: MO LT MM NH
MO: MP LU MN NI
MP: MQ LV MO NJ
MQ: MR LW MP NK
MR: MS LX MQ NL
MS: MT LY MR NM
MT: MU LZ MS NN
MU: MV MA MT NO
MV: w MB MU NP
MW: MX MC w NQ
MX: MY MD MW NR
MY: MZ ME MX NS
MZ: NA MF MY NT
NA: NB MG MZ NU
NB: NC MH NA NV
NC: ND MI NB NW
ND: NE MJ NC NX
NE: NF MK ND NY
NF: NG ML NE NZ
NG: NH MM NF OA
NH: NI MN NG OB
NI: NJ MO NH OC
NJ: NK MP NI OD
NK: NL MQ NJ OE
NL: NM MR NK OF
NM: NN MS NL OG
NN: NO MT NM OH
NO: NP MU NN OI
NP: w MV NO OJ
NQ: NR MW w w
NR: NS MX NQ w
NS: NT MY NR w
NT: NU MZ NS w
NU: NV NA NT w
NV: NW NB NU w
NW: NX NC NV w
NX: NY ND NW w
NY: NZ NE NX w
NZ: OA NF NY w
OA: OB NG NZ w
OB: OC NH OA w
OC: OD NI OB w
OD: OE NJ OC w
OE: OF NK OD w
OF: OG NL OE w
OG: OH NM OF w
OH: OI NN OG w
OI: OJ NO OH w
OJ: w NP OI w
