AS
A: B w w V
B: C w A W
C: D w B X
D: E w C Y
E: F w D Z
F: G w E AA
G: H w F AB
H: I w G AC
I: J w H AD
J: K w I AE
K: L w J AF
L: M w K AG
M: N w L AH
N: O w M AI
O: P w N AJ
P: Q w O AK
Q: R w P AL
R: S w Q AM
S: T w R AN
T: U w S AO
U: w w T AP
V: W A w AQ
W: X B V AR
X: Y C W AS
Y: Z D X AT
Z: AA E Y AU
AA: AB F Z AV
AB: AC G AA AW
AC: AD H AB AX
AD: AE I AC AY
AE: AF J AD AZ
AF: AG K AE BA
AG: AH L AF BB
AH: AI M AG BC
AI: AJ N AH BD
AJ: AK O AI BE
AK: AL P AJ BF
AL: AM Q AK BG
AM: AN R AL BH
AN: AO S AM BI
AO: AP T AN BJ
AP: w U AO BK
AQ: AR V w BL
AR: AS W AQ BM
AS: AT X AR BN
AT: AU Y AS BO
AU: AV Z AT BP
AV: AW AA AU BQ
AW: AX AB AV BR
AX: AY AC AW BS
AY: AZ AD AX BT
AZ: BA AE AY BU
BA: BB AF AZ BV
BB: BC AG BA BW
BC: BD AH BB BX
BD: BE AI BC BY
BE: BF AJ BD BZ
BF: BG AK BE CA
BG: BH AL BF CB
BH: BI AM BG CC
BI: BJ AN BH CD
BJ: BK AO BI CE
BK: w AP BJ CF
BL: BM AQ w CG
BM: BN AR BL CH
BN: BO AS BM CI
BO: BP AT BN CJ
BP: BQ AU BO CK
BQ: BR AV BP CL
BR: BS AW BQ CM
BS: BT AX BR CN
BT: BU AY BS CO
BU: BV AZ BT CP
*BV: BW BA BU CQ
BW: BX BB BV CR
BX: BY BC BW CS
BY: BZ BD BX CT
BZ: CA BE BY CU
CA: CB BF BZ CV
CB: CC BG CA CW
CC: CD BH CB CX
CD: CE BI CC CY
CE: CF BJ CD CZ
CF: w BK CE DA
CG: CH BL w DB
CH: CI BM CG DC
CI: CJ BN CH DD
CJ: CK BO CI DE
CK: CL BP CJ DF
CL: CM BQ CK DG
CM: CN BR CL DH
CN: CO BS CM DI
CO: CP BT CN DJ
CP: CQ BU CO DK
CQ: CR BV CP DL
CR: CS BW CQ DM
CS: CT BX CR DN
CT: CU BY CS DO
CU: CV BZ CT DP
CV: CW CA CU DQ
*CW: CX CB CV DR
CX: CY CC CW DS
CY: CZ CD CX DT
CZ: DA CE CY DU
DA: w CF CZ DV
DB: DC CG w DW
DC: DD CH DB DX
DD: DE CI DC DY
DE: DF CJ DD DZ
DF: DG CK DE EA
DG: DH CL DF EB
DH: DI CM DG EC
DI: DJ CN DH ED
DJ: DK CO DI EE
DK: DL CP DJ EF
DL: DM CQ DK EG
DM: DN CR DL EH
DN: DO CS DM EI
DO: DP CT DN EJ
DP: DQ CU DO EK
DQ: DR CV DP EL
DR: DS CW DQ EM
DS: DT CX DR EN
DT: DU CY DS EO
DU: DV CZ DT EP
DV: w DA DU EQ
DW: DX DB saída ER
DX: DY DC DW ES
DY: DZ DD DX ET
DZ: EA DE DY EU
EA: EB DF DZ EV
EB: EC DG EA EW
EC: ED DH EB EX
ED: EE DI EC EY
EE: EF DJ ED EZ
EF: EG DK EE FA
EG: EH DL EF FB
EH: EI DM EG FC
EI: EJ DN EH FD
*EJ: EK DO EI FE
EK: EL DP EJ FF
EL: EM DQ EK FG
EM: EN DR EL FH
EN: EO DS EM FI
EO: EP DT EN FJ
EP: EQ DU EO FK
EQ: w DV EP FL
ER: ES DW w FM
ES: ET DX ER FN
ET: EU DY ES FO
EU: EV DZ ET FP
EV: EW EA EU FQ
EW: EX EB EV FR
EX: EY EC EW FS
*EY: EZ ED EX FT
EZ: FA EE EY FU
FA: FB EF EZ FV
FB: FC EG FA FW
FC: FD EH FB FX
FD: FE EI FC FY
FE: FF EJ FD FZ
FF: FG EK FE GA
FG: FH EL FF GB
FH: FI EM FG GC
FI: FJ EN FH GD
*FJ: FK EO FI GE
FK: FL EP FJ GF
FL: w EQ FK GG
FM: FN ER w GH
FN: FO ES FM GI
FO: FP ET FN GJ
FP: FQ EU FO GK
FQ: FR EV FP GL
FR: FS EW FQ GM
FS: FT EX FR GN
FT: FU EY FS GO
FU: FV EZ FT GP
FV: FW FA FU GQ
FW: FX FB FV GR
FX: FY FC FW GS
FY: FZ FD FX GT
FZ: GA FE FY GU
GA: GB FF FZ GV
GB: GC FG GA GW
GC: GD FH GB GX
GD: GE FI GC GY
GE: GF FJ GD GZ
GF: GG FK GE HA
GG: w FL GF HB
GH: GI FM w HC
GI: GJ FN GH HD
GJ: GK FO GI HE
GK: GL FP GJ HF
GL: GM FQ GK HG
GM: GN FR GL HH
GN: GO FS GM HI
GO: GP FT GN HJ
GP: GQ FU GO HK
GQ: GR FV GP HL
GR: GS FW GQ HM
GS: GT FX GR HN
GT: GU FY GS HO
GU: GV FZ GT HP
GV: GW GA GU HQ
GW: GX GB GV HR
GX: GY GC GW HS
GY: GZ GD GX HT
GZ: HA GE GY HU
HA: HB GF GZ HV
HB: w GG HA HW
HC: HD GH w HX
HD: HE GI HC HY
HE: HF GJ HD HZ
HF: HG GK HE IA
HG: HH GL HF IB
HH: HI GM HG IC
HI: HJ GN HH ID
HJ: HK GO HI IE
HK: HL GP HJ IF
HL: HM GQ HK IG
HM: HN GR HL IH
HN: HO GS HM II
HO: HP GT HN IJ
HP: HQ GU HO IK
HQ: HR GV HP IL
HR: HS GW HQ IM
HS: HT GX HR IN
HT: HU GY HS IO
HU: HV GZ HT IP
HV: HW HA HU IQ
HW: w HB HV IR
HX: HY HC w IS
HY: HZ HD HX IT
HZ: IA HE HY IU
IA: IB HF HZ IV
IB: IC HG IA IW
IC: ID HH IB IX
ID: IE HI IC IY
IE: IF HJ ID IZ
IF: IG HK IE JA
IG: IH HL IF JB
IH: II HM IG JC
II: IJ HN IH JD
IJ: IK HO II JE
IK: IL HP IJ JF
IL: IM HQ IK JG
IM: IN HR IL JH
IN: IO HS IM JI
IO: IP HT IN JJ
IP: IQ HU IO JK
IQ: IR HV IP JL
IR: w HW IQ JM
IS: IT HX w JN
IT: IU HY IS JO
IU: IV HZ IT JP
IV: IW IA IU JQ
IW: IX IB IV JR
IX: IY IC IW JS
IY: IZ ID IX JT
IZ: JA IE IY JU
JA: JB IF IZ JV
JB: JC IG JA JW
JC: JD IH JB JX
JD: JE II JC JY
JE: JF IJ JD JZ
JF: JG IK JE KA
JG: JH IL JF KB
JH: JI IM JG KC
JI: JJ IN JH KD
JJ: JK IO JI KE
JK: JL IP JJ KF
JL: JM IQ JK KG
JM: saída IR JL KH
JN: JO IS w KI
JO: JP IT JN KJ
JP: JQ IU JO KK
JQ: JR IV JP KL
JR: JS IW JQ KM
JS: JT IX JR KN
JT: JU IY JS KO
JU: JV IZ JT KP
JV: JW JA JU KQ
JW: JX JB JV KR
JX: JY JC JW KS
JY: JZ JD JX KT
*JZ: KA JE JY KU
KA: KB JF JZ KV
KB: KC JG KA KW
KC: KD JH KB KX
KD: KE JI KC KY
KE: KF JJ KD KZ
KF: KG JK KE LA
KG: KH JL KF LB
KH: w JM KG LC
KI: KJ JN w LD
KJ: KK JO KI LE
KK: KL JP KJ LF
KL: KM JQ KK LG
*KM: KN JR KL LH
KN: KO JS KM LI
KO: KP JT KN LJ
KP: KQ JU KO LK
KQ: KR JV KP LL
KR: KS JW KQ LM
KS: KT JX KR LN
KT: KU JY KS LO
KU: KV JZ KT LP
KV: KW KA KU LQ
KW: KX KB KV LR
KX: KY KC KW LS
KY: KZ KD KX LT
KZ: LA KE KY LU
LA: LB KF KZ LV
LB: LC KG LA LW
LC: w KH LB LX
LD: LE KI w LY
LE: LF KJ LD LZ
LF: LG KK LE MA
LG: LH KL LF MB
LH: LI KM LG MC
LI: LJ KN LH MD
LJ: LK KO LI ME
LK: LL KP LJ MF
LL: LM KQ LK MG
LM: LN KR LL MH
LN: LO KS LM MI
LO: LP KT LN MJ
LP: LQ KU LO MK
LQ: LR KV LP ML
LR: LS KW LQ MM
LS: LT KX LR MN
LT: LU KY LS MO
LU: LV KZ LT MP
LV: LW LA LU MQ
LW: LX LB LV MR
LX: w LC LW MS
LY: LZ LD w MT
LZ: MA LE LY MU
MA: MB LF LZ MV
MB: MC LG MA MW
MC: MD LH MB MX
MD: ME LI MC MY
ME: MF LJ MD MZ
MF: MG LK ME NA
MG: MH LL MF NB
MH: MI LM MG NC
MI: MJ LN MH ND
MJ: MK LO MI NE
MK: ML LP MJ NF
ML: MM LQ MK NG
MM: MN LR ML NH
MN: MO LS MM NI
MO: MP LT MN NJ
MP: MQ LU MO NK
MQ: MR LV MP NL
MR: MS LW MQ NM
MS: w LX MR NN
MT: MU LY w NO
MU: MV LZ MT NP
MV: MW MA MU NQ
MW: MX MB MV NR
MX: MY MC MW NS
MY: MZ MD MX NT
MZ: NA ME MY NU
NA: NB MF MZ NV
NB: NC MG NA NW
NC: ND MH NB NX
ND: NE MI NC NY
NE: NF MJ ND NZ
NF: NG MK NE OA
NG: NH ML NF OB
NH: NI MM NG OC
NI: NJ MN NH OD
NJ: NK MO NI OE
NK: NL MP NJ OF
NL: NM MQ NK OG
NM: NN MR NL OH
NN: w MS NM OI
NO: NP MT w OJ
NP: NQ MU NO OK
NQ: NR MV NP OL
NR: NS MW NQ OM
NS: NT MX NR ON
NT: NU MY NS OO
NU: NV MZ NT OP
NV: NW NA NU OQ
NW: NX NB NV OR
NX: NY NC NW OS
NY: NZ ND NX OT
NZ: OA NE NY OU
OA: OB NF NZ OV
OB: OC NG OA OW
OC: OD NH OB OX
OD: OE NI OC OY
OE: OF NJ OD OZ
OF: OG NK OE PA
*OG: OH NL OF PB
OH: OI NM OG PC
OI: w NN OH PD
OJ: OK NO w PE
OK: OL NP OJ PF
OL: OM NQ OK PG
OM: ON NR OL PH
ON: OO NS OM PI
OO: OP NT ON PJ
OP: OQ NU OO PK
OQ: OR NV OP PL
OR: OS NW OQ PM
OS: OT NX OR PN
OT: OU NY OS PO
OU: OV NZ OT PP
OV: OW OA OU PQ
OW: OX OB OV PR
OX: OY OC OW PS
OY: OZ OD OX PT
OZ: PA OE OY PU
PA: PB OF OZ PV
PB: PC OG PA PW
PC: PD OH PB PX
PD: w OI PC PY
PE: PF OJ w w
PF: PG OK PE w
PG: PH OL PF w
PH: PI OM PG w
PI: PJ ON PH w
PJ: PK OO PI w
PK: PL OP PJ w
PL: PM OQ PK w
PM: PN OR PL w
PN: PO OS PM w
PO: PP OT PN w
PP: PQ OU PO saída
PQ: PR OV PP w
PR: PS OW PQ w
PS: PT OX PR w
PT: PU OY PS w
PU: PV OZ PT w
PV: PW PA PU w
PW: PX PB PV w
PX: PY PC PW w
PY: w PD PX w
