BD
A: B w w K
B: C w A w
C: D w B w
D: E w C w
E: w w D w
F: G w w P
G: H w F Q
H: I w G R
I: J w H S
J: w w I T
K: w A w U
L: M w w V
M: N w L W
N: O w M X
O: P w N Y
P: Q F O Z
Q: R G P AA
R: S H Q AB
S: T I R AC
T: w J S AD
U: w K w AE
V: W L w w
W: X M V AG
X: Y N W AH
Y: Z O X AI
Z: AA P Y AJ
AA: AB Q Z AK
AB: AC R AA AL
AC: AD S AB AM
AD: w T AC AN
AE: AF U w AO
AF: w w AE AP
AG: AH W w AQ
AH: AI X AG AR
AI: AJ Y AH AS
AJ: AK Z AI AT
AK: AL AA AJ w
AL: AM AB AK w
AM: AN AC AL w
AN: w AD AM w
AO: AP AE w AY
AP: w AF AO AZ
AQ: AR AG w BA
AR: AS AH AQ BB
AS: AT AI AR BC
AT: w AJ AS BD
AU: AV w w BE
AV: AW w AU BF
AW: AX w AV BG
AX: w w AW BH
AY: AZ AO saída BI
AZ: w AP AY BJ
BA: BB AQ w BK
BB: BC AR BA BL
BC: BD AS BB BM
BD: w AT BC BN
BE: BF AU w BO
BF: BG AV BE BP
BG: BH AW BF BQ
BH: w AX BG BR
BI: BJ AY w BS
BJ: w AZ BI BT
BK: BL BA w BU
BL: BM BB BK BV
BM: BN BC BL BW
BN: w BD BM BX
BO: BP BE w BY
BP: BQ BF BO BZ
BQ: BR BG BP CA
BR: saída BH BQ CB
BS: BT BI w CC
BT: w BJ BS CD
BU: BV BK w w
BV: BW BL BU w
BW: BX BM BV w
BX: w BN BW w
BY: BZ BO w CI
BZ: CA BP BY CJ
CA: CB BQ BZ CK
CB: w BR CA CL
CC: CD BS w CM
CD: w BT CC CN
CE: CF w w CO
CF: CG w CE CP
CG: CH w CF CQ
CH: CI w CG CR
CI: CJ BY CH CS
CJ: CK BZ CI CT
CK: CL CA CJ CU
CL: w CB CK CV
CM: CN CC w w
CN: w CD CM w
CO: CP CE w w
CP: CQ CF CO w
CQ: CR CG CP w
CR: CS CH CQ w
CS: CT CI CR w
CT: CU CJ CS w
CU: CV CK CT w
CV: w CL CU w
