D
B: C w w J
C: D w B K
D: E w C L
E: F w D M
F: G w E N
G: H w F O
H: w w G P
J: K B w w
K: L C J w
L: M D K T
M: N E L U
N: O F M w
O: P G N w
P: w H O w
T: U L w AB
U: w M T AC
Z: AA w w AH
AA: AB w Z AI
AB: AC T AA AJ
AC: w U AB AK
AG: AH w w AO
AH: AI Z AG w
AI: AJ AA AH w
AJ: AK AB AI AR
AK: AL AC AJ AS
AL: saída w AK AT
AO: w AG w AW
AR: AS AJ w AZ
AS: AT AK AR w
AT: AU AL AS BB
AU: w w AT BC
*AW: w AO w BE
AZ: w AR w BH
BB: BC AT w BJ
BC: BD AU BB BK
BD: w w BC BL
BE: BF AW w BM
BF: BG w BE BN
BG: BH w BF BO
BH: w AZ BG BP
BJ: BK BB w BR
*BK: BL BC BJ BS
BL: w BD BK BT
BM: BN BE saída BU
BN: BO BF BM BV
BO: BP BG BN BW
BP: w BH BO BX
BR: BS BJ w BZ
BS: BT BK BR CA
BT: w BL BS CB
BU: BV BM w w
BV: BW BN BU w
BW: BX BO BV w
BX: w BP BW w
BZ: CA BR w w
CA: CB BS BZ w
CB: w BT CA w
